歸字謠	蒼梧謠 十六字令
梧桐影	明月斜
囉嗊曲	望夫歌
南歌子	春宵曲 水晶簾 碧窗夢 十愛詞 南柯子 望秦川 風蝶令
三台	開元樂 翠華引
漁歌子	漁父 漁父樂
憶江南	謝秋娘 江南好 春去也 望江南 夢江南 夢江口 望江梅 安陽好 夢仙遊 步虛聲 壺山好 望蓬萊 歸塞北
搗練子	搗練子令 深院月
春曉曲	西樓月
壽陽曲	落梅風
天淨沙	塞上秋
甘州曲	甘州子
喜春來	陽春曲
秋風清	秋風引 江南路 新安路
拋球樂	莫思歸
憶王孫	獨腳令 憶君王 豆葉黃 畫娥眉 欄杆萬里心 怨王孫
金字經	閱金經
古調笑	宮中調笑 轉應曲 三台令
如夢令	憶仙姿 宴桃源 不見 比梅 古記 無夢令 如意令
訴衷情	桃花水
天仙子	萬斯年
歸自謠	風光子 思佳客
江城子	江神子 村意遠
長相思	吳山青 山漸青 青山相送迎 長相思令 相思令
相見歡	秋夜月 上西樓 西樓子 憶真妃 月上瓜州 烏夜啼
河滿子	何滿子
望梅花	望梅花令
醉太平	淩波曲 醉思凡 四字令
長命女	薄命女
春光好	愁倚闌令 愁倚闌 倚闌令
生查子	楚雲深 梅和柳 晴色入青山
添聲楊柳枝	賀聖朝影 太平時
醉公子	四換頭
昭君怨	洛妃怨 宴西園
玉蝴蝶	玉蝴蝶慢
女冠子	女冠子慢
中興樂	濕羅衣
點絳唇	點櫻桃 十八香 南浦月 沙頭雨 尋瑤草
平湖樂	小桃紅 採蓮詞
歸國遙	歸平遙
贊浦子	贊普子
浣溪沙	小庭花 減字浣溪沙 滿院春 東風寒 醉木犀 霜菊花 廣寒枝 試香羅 清和風 怨啼鵑
沙塞子	沙磧子
殿前歡	鳳將雅
霜天曉角	月當窗 踏月 長橋月
清商怨	關河令 傷情怨
菩薩蠻	重疊金 子夜歌 菩薩鬘 花間意 梅花句 花溪碧 晚雲烘日
採桑子	醜奴兒令 羅敷媚歌 醜奴兒 羅敷媚
後庭花	玉樹後庭花
訴衷情令	漁父家風 一絲風
減字木蘭花	減蘭 木蘭香 天下樂令
卜算子	缺月掛疏桐 百尺樓 楚天謠 眉峰碧
一落索	洛陽春 玉連環 一絡索
謁金門	空相憶 花自落 垂楊碧 楊花落 出塞 東風吹酒面 不怕醉 醉花春 春早湖山
好事近	釣船笛 翠圓枝
好女兒	繡帶兒
彩鸞歸令	青山遠
清平樂	清平樂令 憶蘿月 醉東風
憶秦娥	秦樓月 雙荷葉 蓬萊閣 碧雲深 花深深
朝天子	思越人
憶少年	隴首山 十二時 桃花曲
相思引	玉交枝 定風波令 琴調相思引 鏡中人
江亭怨	清平樂令 荊州亭
喜遷鶯	鶴沖天 萬年枝 春光好 喜遷鶯令 燕歸來 早梅芳 烘春桃李
烏夜啼	聖無憂 錦堂春
相思兒令	相思令
阮郎歸	碧桃春 醉桃源 宴桃源 濯纓曲
賀聖朝	轉調賀聖朝
山花子	南唐浣溪沙 添字浣溪沙 攤破浣溪沙 感恩多令
胡搗練	望仙樓
桃源憶故人	虞美人影 胡搗練 桃園憶故人 醉桃園 杏花風
撼庭秋	感庭秋
慶金枝	慶金枝令
燭影搖紅	憶故人 歸去曲 玉珥墜金環 秋色橫空
朝中措	照江梅 芙蓉曲 梅月圓
眼兒媚	小欄杆 東風寒 秋波媚
人月圓	青衫濕
喜團圓	與團圓
海棠春	海棠花 海棠春令
武陵春	武林春
鬲溪梅令	高溪梅令
月宮春	月中行
極相思	極相思令
柳梢青	雲淡秋空 雨洗元宵 玉水明沙 早春怨 隴頭月
醉鄉春	添春色
太常引	太清引 臘前梅
應天長	應天長令 應天長慢
少年遊	玉臘梅枝 小欄杆
憶漢月	望漢月
西江月	白蘋香 步虛詞 江月令
梁州令	涼州令 梁州令疊韻
歸田樂	歸田樂引
惜分飛	惜雙雙 惜雙雙令 惜芳菲
促拍採桑子	促拍醜奴兒
四犯令	四和香 桂華明
探春令	景龍燈
越江吟	宴瑤池 瑤池宴 瑤池宴令
雨中花令	送將歸
伊州令	伊川令
引駕行	長春
雙雁兒	雙燕子
尋芳草	王孫信
恨來遲	恨歡遲
紅窗聽	紅窗睡
折桂令	秋風第一枝 天香引 蟾宮曲
臨江仙	謝新恩 雁後歸 畫屏春 庭院深深
浪淘沙令	曲入冥 賣花聲 過龍門 煉丹砂
金錯刀	醉瑤瑟 君來路
端正好	於中好
杏花天	杏花風
戀繡衾	淚珠彈
擷芳詞	折紅英 清商怨 惜分釵 釵頭鳳 玉瓏璁
鸚鵡曲	黑漆弩 學士吟
河傳	怨王孫 慶同天 月照梨花 秋光滿目
夜行船	明月棹孤舟
鷓鴣天	思越人 思佳客 剪朝霞 驪歌一疊 醉梅花
虞美人	虞美人令 玉壺冰 憶柳曲 一江春水
瑞鷓鴣	舞春風 桃花落 鷓鴣詞 拾菜娘 天下樂 太平樂 五拍
玉樓春	惜春容 西湖曲 玉樓春令 歸朝歡令
鵲橋仙	鵲橋仙令 憶人人 金風玉露相逢曲 廣寒秋
卓牌子	卓牌子令 卓牌子慢
廳前柳	亭前柳
一斛珠	一斛夜明珠 醉落魄 怨春風 醉落拓
夜遊宮	新念別
梅花引	貧也樂 小梅花
小重山	小沖山 小重山令 柳色新
踏莎行	喜朝天 柳長春 踏雪行 轉調踏莎行
掃地舞	掃市舞
接賢賓	集賢賓
步蟾宮	釣臺詞 折丹桂
冉冉雲	弄花雨
蝶戀花	鵲踏枝 黃金縷 捲珠簾 明月生南浦 細雨吹池沼 鳳棲梧 一籮金 魚水同歡 轉調蝶戀花
少年心	添字少年心
一翦梅	臘梅香 玉簟秋
唐多令	糖多令 南樓令 箜篌曲
繫裙腰	芳草渡
定風波	定風流 定風波令
破陣子	十拍子
蘇幕遮	鬢雲松令
攤破南鄉子	青杏兒 似娘兒 慶靈椿 閑閑令
醉春風	怨東風
握金釵	戛金釵
錦纏道	錦纏頭 錦纏絆
厭金杯	獻金杯
謝池春	風中柳 風中柳令 玉蓮花 賣花聲
勝勝令	聲聲令
青玉案	西湖路
夢行雲	六么花十八
鳳凰閣	數花風
連理枝	紅娘子 小桃紅 灼灼花
月上海棠	玉關遙 月上海棠慢
小鎮西犯	小鎮西 鎮西
千秋歲	千秋節
甘露歌	祝英台
于飛樂	鴛鴦怨曲
隔浦蓮近拍	隔浦蓮 隔浦蓮近
風入松	風入松慢 遠山橫
剔銀燈	剔銀燈引
解蹀躞	玉蹀躞
撲蝴蝶	撲蝴蝶近
千年調	相思會
番槍子	春草碧
荔枝香	荔枝香近
婆羅門引	婆羅門 望月婆羅門引
御街行	孤雁兒
祝英台近	寶釵分 月底修簫譜 燕鶯語 寒食詞
陽關引	古陽關
金人捧露盤	銅人捧露盤 上平西 上西平 西平曲 上平南
鬥百花	夏州
最高樓	醉高春
彩鳳飛	彩鳳舞
驀山溪	上陽春
千秋歲引	千秋歲令 千秋萬歲
早梅芳	早梅芳近
新荷葉	折新荷引 泛蘭舟
促拍滿路花	滿路花 滿園花 歸去難 一枝花 喝馬一枝花
洞仙歌	洞仙歌令 羽仙歌 洞仙詞 洞中仙 洞仙歌慢
蕙蘭芳引	蕙蘭芳
受恩深	愛恩深
五福降中天	五福降中天慢
江城梅花引	攤破江城子 四笑江梅引 梅花引 明月引 西湖明月引
八六子	感黃鸝
採桑子慢	醜奴兒慢 愁春未醒 醜奴兒近 疊青錢
探芳信	西湖春
法曲獻仙音	獻仙音 越女鏡心
露華	露華慢
淒涼犯	瑞鶴仙影
浣溪沙慢	浣溪紗慢
四犯剪梅花	轆轤金井 三犯錦園春 月城春 錦園春
尾犯	碧芙蓉
六么令	綠腰 樂世 錄要
水調歌頭	元會曲 凱歌
掃地遊	掃花遊
滿庭芳	鎖陽臺 滿庭霜 瀟湘夜雨 話桐鄉 江南好 滿庭花 轉調滿庭芳
小聖樂	驟雨打新荷
漢宮春	漢宮春慢
倦尋芳	倦尋芳慢
八聲甘州	甘州 蕭蕭雨 宴瑤池
醉蓬萊	雪月交光 冰玉風月
鳳凰臺上憶吹簫	憶吹簫
慶清朝	慶清朝慢
燕春台	夏初臨
聲聲慢	勝勝慢 人在樓上
瑣窗寒	鎖寒窗
十月桃	十月梅
新雁過妝樓	雁過妝樓 瑤台聚八仙 八寶妝 百寶妝
國香	國香慢
芳草	鳳簫吟
念奴嬌	大江東去 酹江月 赤壁詞 酹月 壺中天慢 大江西上曲 太平歡 壽南枝 古梅曲 湘月 淮甸春 白雪詞 百字令 百字謠 無俗念 千秋歲 慶長春 杏花天
渡江雲	三兒犯渡江雲
高陽臺	慶春澤慢 慶宮春
桂枝香	疏簾淡月
錦堂春慢	錦堂春
西平樂	西平樂慢
水龍吟	豐年瑞 鼓笛慢 龍吟曲 小樓連苑 莊椿歲
石州慢	柳色黃 石州引
宴清都	四代好
慶春宮	慶宮春
憶舊遊	憶舊遊慢
花犯	繡鸞鳳花犯
倒犯	吉了犯
瑞鶴仙	一撚紅
齊天樂	台城路 五福降中天 如此江山
氐州第一	熙州摘遍
瑤華	瑤花慢
竹馬兒	竹馬子
憶瑤姬	別素質 別瑤姬慢
探春慢	探春
眉嫵	百宜嬌
湘江靜	瀟湘靜
歸朝歡	菖蒲綠
永遇樂	消息
二郎神	轉調二郎神 十二郎
傾杯樂	古傾杯 傾杯
月中桂	月中仙
拜星月慢	拜新月
花心動	好心動 桂香飄 上升花 花心慢動
陽春	陽春曲
西河	西河慢 西湖
秋霽	春霽
解連環	望梅 杏樑燕
夜飛鵲慢	夜飛鵲
落梅	落梅慢
飛雪滿群山	遍扁尋舊約 飛雪滿堆山
泛青苕	感皇恩慢
奪錦標	清溪怨
江城子慢	江神子慢
八寶妝	八犯玉交枝
疏影	綠意 解佩環
選冠子	選官子 轉調選冠子 惜餘春慢 蘇武慢 過秦樓
霜葉飛	半嬋娟
沁園春	東仙 壽星明 洞庭春色
瑤台月	瑤池月
摸魚兒	買陂塘 陂塘柳 邁陂塘 山鬼謠 雙蕖怨
賀新郎	金縷歌 金縷曲 金縷詞 乳燕飛 賀新涼 風敲竹 貂裘換酒
弔嚴陵	暮雲碧
金明池	昆明池 夏雲峰
笛家	笛家弄慢
秋思耗	畫屏秋色
多麗	鴨頭綠 隴頭泉
寶鼎現	三段子 寶鼎兒
哨遍	稍遍
戚氏	夢遊仙
鶯啼序	豐樂樓
